F 220,100,0
C 225,30,0
NO ./img/doomwall.png
SO ./img/doomwall.png
EA ./img/nukewall.png
WE ./img/nukewall.png


1111111111
1000000011
1001000011
1000100011
1111100011
1000000011
1001000011
1000111111
1N00000001
1111111111