NO ./img/doomwall.png
EA ./img/nukewall.png
SO ./img/doomwall.png
WE ./img/nukewall.png

F 220,100,0
C 225,30,0

1111111111111111111111111111111111111
1000000000000000000000000000000000001
1001000000100000010000001000000100001
1000100000010000001000000100000010001
1111100011110001111000111100011110001
1000000000000000000000000000000000001
1001000000100000010000001000000100001
1000111100011110001111000111100011111
1N00000000000000000000000000000000001
1111111111111111111111111111111111111