NO                 ./img/doomwall.png\n
EA ./img/nukewall.png

WE ./img/nukewall.png
F 220             ,        100,            
C 225,30,1

SO ./img/doomwall.png
SO ./img/doomwall.png


1111111111
111111101
1000001111
1000001
1110011111
11100E1001
10000111111
1111111
