NO ./img/doomwall.png
EA ./img/nukewall.png
SO ./img/doomwall.png
WE ./img/nukewall.png

C 0, 157, 225
F 67, 225, 0

1111111
10000W1
1000001
1110001
1110001
1000011
1000011
1000011
1111111