NO ./maps/texture/fuji.png
SO ./maps/texture/fuji.png
WE ./maps/texture/fuji.png
EA ./maps/texture/fuji.png

F 71,135,87
C 127,224,224
        1111111111111111111111111
        10000000001100000000010E1
        1011000001110000000001111
        1001000000000000000000001
111111111011000001110000000000001
100000000011000001110111111111111
11110111111111011100000010001
11110111111111011101010010001
11000000110101011100000010001
10000000000000001100000010001
10000000000000001101010010001
1100000111010101111101111000111
11110111 1110101 101111010001
11111111 1111111 111111111111