
NO ./maps/texture/japan1.png
SO ./maps/texture/japan2.png

EA ./maps/texture/japan2.png
WE ./maps/texture/japan1.png
F 71,135,87
C 127,224,224

 111111  11111111111111111111111111
100000011000000000000000000000000001
100010000000000000000000000000000001
100010001000000000000000000000000001
100000000000000000000000000000000001
100010100000000000000000000000000001
100000N00000000000000000000000000001
100000000000000000000000011000000001
100000000000000000000000011100000001
100010100000000010000000000000000001
100000000000000010000000000000000001
100000000000001100000000000000000001
100000000000110000000010000000000001
100011000000000000001100000000000001
100001000000000000000000000000000001
100001000000000001000000000000000001 
100000000000000000000000000010000001
100000000000001111000000000000100001
100000000000000100000000000000000001
 1111111111111111111111111111111111 