F 71,135,87
C 127,224,224
NO ./maps/texture/arcade_mountain.png
SO ./maps/texture/camp_side.png
WE ./maps/texture/arcade_mountain.png
EA ./maps/texture/camp_side.png


                                                        111111
                                                        11000111111111
                11111111111111111                       11000000000001
                100000011100000011111111111111111111111111000000000001
                100000011100000000000000000000000000000000000000000001
                100000000000000011111111111111111001111111111111011111
                10000011011100001               1001           101
                10000000000000001               1001           101111111111111111
                10000110E00001101               1001           100000000000000001
                10000000000001101           111110011111       111111111111111101
                10000111000000001           100000000001                      101
                10000001000000001           100011000001                      101
                10000001000000001111111111111000110000011111111111111111111111101
                10000001000000000000000000000000110110000000000000000000000000001
                11111011111111111111111111111000110000011111111111111111111111101
                    101                     100011000001                      101
                11111011111111111           100000000001                      101
                10000000000000001           111110011111                      101
                10110001110000001               1001                          101
                10000000110000001111111111111111100111111111111111111111111111101
                10110000110000000000000000000000000000000000000000000000000000001
                10000000000000001111111111111111111111111111111111111111111111111
                10001111111000001
                10001110000000001
                10001111111000001
                10000000000000111
                10000001110000001111111111111
                10000001110000000000000000001
                11111111111111111111111111101
                                         11011
                                        11000111111111
11111111111111111                       11000000000001
100000000000000011111111111111111111111111000000011111
100000000000000000000000000000000000000000000000000001
100000000000000011111111111111111001111111111111011111
10000000000000001               1001           101
10000000000000001               1001           101111111111111111
10000000000000001               1001           100000000000000001
10000000000000001           111110011111       111111111111111101
10000000000000001           100000000001                      101
10000000000000001           100000000001                      101
10000000000000001111111111111000111000011111111111111111111111101111111111111111111111111111111111111111111111111111111111111111111111111111111111111111111111111111111
10000000000000000000000000000000111000000000000000000000000000000000000000000000000000000000000000000000000000000000000000000000000000000000000000000000000000000000001
11111011111111111111111111111000111000011111111111111111111111101111111111111111111111111111111111111111111111111111111111111111111111111111111111111111111111111111111
    101                     100000000001                      101
11111011111111111           100000000001                      101
10000000000000001           111110011111                      101
10000000000000001               1001                          101
10000000000000001111111111111111100111111111111111111111111111101
10000000000000000000000000000000000000000000000000000000000000001
10000000000000001111111111111111111111111111111111111111111111111
10000000000000001
10000000000000001
10000000000000001
10000000000000001
10000000000000001
10000000000000001
11111111111111111