F 71,135,87
C 127,224,224
NO ./maps/texture/mario_scene.png
SO ./maps/texture/purple_tentacle_2.png
WE ./maps/texture/test.png
EA ./maps/texture/yellow.png


        1111111111111111111111111
        10000000001100000000000011
        10011000001110000000000011
        10010000000000000000000011
111111111011000001110000000000001
100000000011000001110111110111111
11110111111111011100000010001
11110111111111011101010010001
1100000011E101011100000000001
10000000000000001100000010001
10000000000000001101010010001
1100000111010101111101111000111
11111111 1110101 101111010001
11111111 1111111 111111111111